  2 2 
  3 3 
  4 4 
  5 3 2 
  6 6 
  7 1 1 1 1 1 1 1 
  8 8 
  9 6 3 
 10 8 2 
 11 4 2 2 2 1 
 12 12 
 13 4 2 2 2 2 1 
 14 12 2 
 15 6 6 3 
 16 12 4 
 17 10 5 2 
 18 8 8 2 
 19 2 2 2 2 2 2 2 2 2 1 
 20 6 6 6 2 
 21 2 2 2 2 2 2 2 1 1 1 1 1 1 1 
 22 12 6 4 
 23 6 6 6 3 2 
 24 24 
 25 1 1 1 1 1 1 1 1 1 1 1 1 1 1 1 1 1 1 1 1 1 1 1 1 1 
 26 2 2 2 2 2 2 2 2 2 2 2 2 2 
 27 10 10 5 2 
 28 12 12 4 
 29 6 6 6 6 3 2 
 30 4 4 4 4 4 4 4 2 
 31 6 6 3 3 3 3 3 3 1 
 32 20 12 
 33 1 1 1 1 1 1 1 1 1 1 1 1 1 1 1 1 1 1 1 1 1 1 1 1 1 1 1 1 1 1 1 1 1 
 34 4 4 4 4 4 4 4 4 2 
 35 2 2 2 2 2 2 2 2 2 2 2 2 2 2 2 2 2 1 
 36 2 2 2 2 2 2 2 2 2 2 2 2 2 2 2 2 2 2 
 37 2 2 2 2 2 2 2 2 2 2 2 2 2 2 2 2 2 2 1 
 38 4 4 4 4 4 4 2 2 2 2 2 2 2 
 39 2 2 2 2 2 2 2 2 2 2 2 2 2 2 2 2 2 2 2 1 
 40 12 12 12 4 
 41 12 6 6 6 6 3 2 
 42 10 10 10 10 2 
 43 4 4 2 2 2 2 2 2 2 2 2 2 2 2 2 1 1 1 1 1 1 1 1 1 
 44 24 12 8 
 45 2 2 2 2 2 2 2 2 2 2 2 2 2 2 2 2 2 2 2 2 2 2 1 
 46 4 4 4 4 4 4 4 4 2 2 2 2 2 2 1 1 
 47 2 2 2 2 2 2 2 2 2 2 2 2 2 2 2 2 2 2 2 1 1 1 1 1 1 1 1 1 
 48 24 24 
 49 3 3 3 3 3 3 3 3 3 3 3 3 3 3 3 3 1 
 50 12 12 12 12 2 
 51 6 6 6 6 6 6 6 6 3 
 52 4 4 4 4 4 4 4 4 4 4 4 4 4 
 53 2 2 2 2 2 2 2 2 2 2 2 2 2 2 2 2 2 2 2 2 2 2 2 2 2 2 1 
 54 2 2 2 2 2 2 2 2 2 2 2 2 2 2 2 2 2 2 2 2 2 2 2 2 2 2 2 
 55 1 1 1 1 1 1 1 1 1 1 1 1 1 1 1 1 1 1 1 1 1 1 1 1 1 1 1 1 1 1 1 1 1 1 1 1 1 1 1 1 1 1 1 1 1 1 1 1 1 1 1 1 1 1 1 
 56 4 4 4 4 4 4 4 4 4 4 4 4 4 4 
 57 2 2 2 2 2 2 2 2 2 2 2 2 2 2 2 2 2 2 2 2 2 2 2 2 2 2 2 2 1 
 58 1 1 1 1 1 1 1 1 1 1 1 1 1 1 1 1 1 1 1 1 1 1 1 1 1 1 1 1 1 1 1 1 1 1 1 1 1 1 1 1 1 1 1 1 1 1 1 1 1 1 1 1 1 1 1 1 1 1 
 59 1 1 1 1 1 1 1 1 1 1 1 1 1 1 1 1 1 1 1 1 1 1 1 1 1 1 1 1 1 1 1 1 1 1 1 1 1 1 1 1 1 1 1 1 1 1 1 1 1 1 1 1 1 1 1 1 1 1 1 
 60 2 2 2 2 2 2 2 2 2 2 2 2 2 2 2 2 2 2 2 2 2 2 2 2 2 2 2 2 2 2 
